###########
#E  #     #
### # ### #
#   #S#   #
# ##### # #
#     # # #
##### # # #
#   #   # #
# # ##### #
# #       #
###########
fpx=17,fpy=1,s=@
